0 0 0 0 0 5 5 5 0 0 0 0 0
0 0 0 0 5 0 0 0 5 0 0 0 0
0 0 0 5 3 3 3 3 3 5 0 0 0
0 0 5 2 2 2 2 2 2 2 5 0 0
1 5 0 0 0 1 4 1 0 0 0 5 1
1 5 0 0 0 4 4 4 0 0 0 5 1
1 5 0 0 0 1 1 1 0 0 0 5 1